TILEMAP
18 28 							-- Size of tile map in tiles
32 32 							-- Tile size & block size
images/tilesheet.png 	-- Tilesheet
4 8 							-- Number of tiles in tilesheet
aaaaaaaaaaaaaaaaaa
a                a
a     i1i1i1     a
a     1i1i1i     a
a                a
a                a
a                a
a    ziiiiiiz    a
a    z111111z    a
a    z      z    a
a  1hz      zh1  a
a    z333333z    a
a    z5h333hz    a
a    z7h   hz    a
a    z11zz11z    a
a                a
a                a
a                a
a                a
a                a
a                a
a                a
a                a
a                a
a                a
a   1h      h1   a
a                a
aaaaaa      aaaaaa