TILEMAP
18 28 							-- Size of tile map in tiles
32 32 							-- Tile size & block size
images/tilesheet.png 	-- Tilesheet
4 8 							-- Number of tiles in tilesheet
aaaaaaaaaaaaaaaaaa
a                a
a                a
a 4            4 a
a 44224422442244 a
a                a
a      22        a
a      22        a
a 5            2 a
a 7  1111  1   2 a
a 3  2 zz  2   3 a
a                a
a      3      3  a
a                a
a  3       3     a
a                a
a                a
a                a
a                a
a                a
a                a
a                a
a                a
a                a
a                a
a                a
a                a
aaaaaaa    aaaaaaa