TILEMAP
18 28 							-- Size of tile map in tiles
32 32 							-- Tile size & block size
images/tilesheet.png 	-- Tilesheet
4 8 							-- Number of tiles in tilesheet
aaaaaaaaaaaaaaaaaa
a                a
a                a
a                a
a      hhhh      a
a   jh1    1hj   a
a    h      h    a
a   fh  dd  hf   a
a   gh  ee  hg   a
azzzzhhh22hhhzzzza
a    i  ff  i    a
a   fi1 gg 1if   a
a   gi  zz  ig   a
a   ji1 hh 1ij   a
a   fi      if   a
a   gi      ig   a
azzzzh11dd11hzzzza
a    h  ee  hb   a
a    h      hc   a
a    h1 dd 1h    a
a       ee       a
a       jj       a
a                a
a                a
a                a
a                a
a                a
aaaaaaa    aaaaaaa