TILEMAP
18 28 							-- Size of tile map in tiles
32 32 							-- Tile size & block size
images/tilesheet.png 	-- Tilesheet
4 8 							-- Number of tiles in tilesheet
aaaaaaaaaaaaaaaaaa
a                a
a                a
a                a
a   j        j   a
a    j      j    a
a     j    j     a
a     5          a
a     73333      a
a      3333      a
a     j    j     a
a    j      j    a
a   j        j   a
a  j          j  a
a j            j a
aj              ja
a                a
a                a
a                a
a                a
a                a
a                a
a                a
a                a
a                a
a                a
a                a
aaaaaaa    aaaaaaa
