TILEMAP
18 28 							-- Size of tile map in tiles
32 32 							-- Tile size & block size
images/tilesheet.png 	-- Tilesheet
4 8 							-- Number of tiles in tilesheet
aaaaaaaaaaaaaaaaaa
a  11111         a
a                a
a                a
a                a
a                a
a                a
a                a
a  11111         a
a  33333         a
a                a
a                a
a                a
a                a
a                a
a                a
a                a
a  2222          a
a                a
a                a
a                a
a                a
a                a
a                a
a                a
a                a
a                a
aaaaaaaaaaaaaaaaaa