TILEMAP
18 28 							-- Size of tile map in tiles
32 32 							-- Tile size & block size
images/tilesheet.png 	-- Tilesheet
4 8 							-- Number of tiles in tilesheet
aaaaaaaaaaaaaaaaaa
a                a
a                a
a  i          i  a
a   i        i   a
a    i      i    a
a     i    i     a
a      i  i      a
a       ii       a
a  1    11     1 a
a    1       1   a
a  1    11     1 a
a       hh       a
a      h5 h      a
a     h 7  h     a
a    h      h    a
a   h        h   a
a  h          h  a
a                a
a                a
a                a
a                a
a                a
a                a
a                a
a                a
a                a
aaaaaa      aaaaaa